1 2 2 2 2 2 2 2 2 2 2 2 2 2 2 2 2 2 2 1
1 0 0 0 0 0 0 0 0 0 0 0 0 0 0 0 0 0 0 1
1 0 0 0 0 0 0 0 0 0 0 0 0 0 0 0 0 0 0 1
1 0 0 0 0 0 0 0 0 0 C 0 D 0 0 0 0 0 0 1
1 0 0 0 0 0 0 0 0 0 C 2 2 2 2 2 2 2 2 1
1 0 0 0 0 0 0 0 0 0 C 0 0 0 0 0 0 0 0 1
1 0 0 0 0 0 0 0 0 0 C 0 0 0 0 0 0 0 0 1
1 0 0 0 0 0 0 0 0 0 C 0 0 0 0 0 0 0 0 1
1 0 H O 0 0 0 0 0 0 C 0 0 0 0 0 0 0 0 1
1 0 0 O 0 0 0 0 0 0 C 0 0 0 0 0 D 0 C 1
1 R 0 O 0 0 C 0 0 2 2 2 2 2 2 2 2 2 C 1
1 2 2 2 2 2 C 0 0 0 0 0 0 C 0 0 0 0 C 1
1 0 C 0 0 0 C 0 0 0 0 0 0 C 0 0 0 0 C 1
1 0 C 0 0 0 C 0 0 0 0 0 0 C 0 0 0 D C 1
1 0 C 0 B 0 C 0 0 0 0 0 0 C 2 2 2 2 C 1
1 0 C 2 2 2 2 0 0 0 0 0 0 C 0 0 0 0 0 1
1 0 C 0 0 0 0 0 0 0 0 0 0 C 0 0 0 0 0 1
1 0 C 0 0 0 0 0 0 0 0 0 0 C 0 0 0 0 0 1
1 0 C 0 0 0 0 0 0 D 0 0 0 C 0 0 0 0 0 1
1 3 3 3 3 3 3 3 3 3 3 3 3 3 3 3 3 3 3 1